##########
#P       #
#        #
#   #M   #
#   #    #
#        #
#      G #
#        #
##########